,Name,Height,Age,YearsStudying,Sex,StartAge
0,Alice,165,25,2,Female,23
1,Bob,170,32,5,Male,27
2,Charlie,175,40,4,Male,36
3,Diana,160,22,1,Female,21
4,Edward,180,28,4,Male,24
5,Fiona,155,30,4,Female,26
6,George,168,35,7,Male,28
7,Hannah,172,26,3,Female,23
8,Ivan,178,41,6,Male,35
9,Julia,169,29,2,Female,27
